{
  "version": 1,
  "notes": "",
  "documentation": "\"This file is a QMK Configurator export. You can import this at <https://config.qmk.fm>. It can also be used directly with QMK's source code.\n\nTo setup your QMK environment check out the tutorial: <https://docs.qmk.fm/#/newbs>\n\nYou can convert this file to a keymap.c using this command: `qmk json2c {keymap}`\n\nYou can compile this keymap using this command: `qmk compile {keymap}`\"\n",
  "keyboard": "mechwild/murphpad",
  "keymap": "mechwild_murphpad_layout_mine",
  "layout": "LAYOUT",
  "layers": [
    [
      "KC_MPLY",
      "KC_MSTP",
      "KC_MPRV",
      "KC_MNXT",
      "KC_NLCK",
      "KC_PSLS",
      "KC_PAST",
      "KC_PMNS",
      "KC_P7",
      "KC_P8",
      "KC_P9",
      "KC_PPLS",
      "KC_MUTE",
      "KC_P4",
      "KC_P5",
      "KC_P6",
      "KC_PPLS",
      "MO(1)",
      "KC_P1",
      "KC_P2",
      "KC_P3",
      "KC_PENT",
      "KC_BSPC",
      "KC_P0",
      "KC_P0",
      "KC_PDOT",
      "KC_PENT",
      "KC_F5",
      "KC_F6",
      "KC_F7"
    ],
    [
      "EEP_RST",
      "KC_TRNS",
      "KC_TRNS",
      "DEBUG",
      "KC_TRNS",
      "KC_TRNS",
      "KC_TRNS",
      "KC_TRNS",
      "RGB_HUD",
      "RGB_SPI",
      "RGB_HUI",
      "KC_TRNS",
      "KC_TRNS",
      "RGB_RMOD",
      "RGB_TOG",
      "RGB_MOD",
      "KC_TRNS",
      "KC_TRNS",
      "RGB_VAD",
      "RGB_SPD",
      "RGB_VAI",
      "KC_TRNS",
      "RESET",
      "RGB_SAD",
      "KC_TRNS",
      "RGB_SAI",
      "KC_TRNS",
      "KC_TRNS",
      "KC_TRNS",
      "KC_TRNS"
    ],
    [
      "KC_TRNS",
      "KC_TRNS",
      "KC_TRNS",
      "KC_TRNS",
      "KC_TRNS",
      "KC_TRNS",
      "KC_TRNS",
      "KC_TRNS",
      "KC_TRNS",
      "KC_TRNS",
      "KC_TRNS",
      "KC_TRNS",
      "KC_TRNS",
      "KC_TRNS",
      "KC_TRNS",
      "KC_TRNS",
      "KC_TRNS",
      "KC_TRNS",
      "KC_TRNS",
      "KC_TRNS",
      "KC_TRNS",
      "KC_TRNS",
      "KC_TRNS",
      "KC_TRNS",
      "KC_TRNS",
      "KC_TRNS",
      "KC_TRNS",
      "KC_TRNS",
      "KC_TRNS",
      "KC_TRNS"
    ],
    [
      "KC_TRNS",
      "KC_TRNS",
      "KC_TRNS",
      "KC_TRNS",
      "KC_TRNS",
      "KC_TRNS",
      "KC_TRNS",
      "KC_TRNS",
      "KC_TRNS",
      "KC_TRNS",
      "KC_TRNS",
      "KC_TRNS",
      "KC_TRNS",
      "KC_TRNS",
      "KC_TRNS",
      "KC_TRNS",
      "KC_TRNS",
      "KC_TRNS",
      "KC_TRNS",
      "KC_TRNS",
      "KC_TRNS",
      "KC_TRNS",
      "KC_TRNS",
      "KC_TRNS",
      "KC_TRNS",
      "KC_TRNS",
      "KC_TRNS",
      "KC_TRNS",
      "KC_TRNS",
      "KC_TRNS"
    ]
  ],
  "author": ""
}